0,0,0,0,0,0,0,0,0,0,0,0,0,0,0,0,0,0,0,0,0,0,0,0,0,0,0,0,0,0,0,0,0,0,0,0,0,0,0,0,0,0,0,0,0,0,0,0,0,0,0,0,0,0,0,0,0,0,0,0,0,0,0,0,0,0,0,0,0,0,0,0,0,0,0,0,0,0,0,0,0
2,2,0,0,0,0,0,2,0,2,2,2,0,0,0,2,0,2,2,2,2,2,2,0,0,0,2,0,2,0,2,2,0,0,2,0,2,0,2,0,2,2,0,2,0,1,0,2,2,0,0,2,0,2,0,0,2,2,0,2,2,0,0,0,0,2,0,2,2,2,0,0,1,2,0,2,2,0,0,2,0
1,1,0,0,0,0,0,1,0,5,5,1,0,0,0,1,0,5,6,1,1,6,1,0,0,0,1,0,1,0,1,1,0,0,5,0,6,0,5,0,1,1,0,1,0,6,0,1,6,0,0,1,0,1,0,0,6,1,0,1,1,0,0,0,0,1,0,5,1,5,0,0,6,1,0,1,1,0,0,1,0
0,0,0,0,0,0,0,0,0,0,0,0,0,0,0,0,0,0,0,0,0,0,0,0,0,0,0,0,0,0,0,0,0,0,0,0,0,0,0,0,0,0,0,0,0,0,0,0,0,0,0,0,0,0,0,0,0,0,0,0,0,0,0,0,0,0,0,0,0,0,0,0,0,0,0,0,0,0,0,0,1
0,0,0,0,0,0,0,0,0,0,0,0,0,0,0,0,0,0,0,0,0,0,0,0,0,0,0,0,0,0,0,0,0,0,0,0,0,0,0,0,0,0,0,0,0,0,0,0,0,0,0,0,0,0,0,0,0,0,0,0,0,0,0,0,0,0,0,0,0,0,0,0,0,0,0,0,0,0,0,0,0
0,0,0,0,0,0,0,0,0,0,0,0,0,0,0,0,0,0,0,0,0,0,0,0,0,0,0,0,0,0,0,0,0,0,0,0,0,0,0,0,0,0,0,0,0,0,0,0,0,0,0,0,0,0,0,0,0,0,0,0,0,0,0,0,0,0,0,0,0,0,0,0,0,0,0,0,0,0,0,0,0
2,2,0,2,2,0,2,2,0,0,0,2,2,0,2,0,0,0,0,2,2,2,2,0,0,2,0,0,0,0,2,0,0,0,2,2,0,2,2,0,2,2,0,2,2,2,0,0,2,0,2,0,2,0,0,2,2,2,2,0,2,0,2,0,0,0,2,0,2,0,0,0,0,0,2,0,0,0,0,0,0
1,5,0,1,1,0,1,1,0,0,0,5,1,0,3,6,0,0,0,1,1,1,1,0,0,3,0,0,0,0,3,0,0,0,1,6,0,5,3,0,1,1,0,1,1,1,0,0,1,0,1,0,3,0,0,1,6,6,1,0,6,0,1,0,0,0,1,0,6,0,0,0,0,0,1,0,0,0,0,0,0
0,0,0,0,0,0,0,0,0,0,0,0,0,0,0,0,0,0,0,0,0,0,0,0,0,0,0,0,0,0,0,0,0,0,0,0,0,0,0,0,0,0,0,0,0,0,0,0,0,0,0,0,0,0,0,0,0,0,0,0,0,0,0,0,0,0,0,0,0,0,0,0,0,0,0,0,0,0,0,0,0
0,0,0,0,0,0,0,0,0,0,0,0,0,0,0,0,0,0,0,0,0,0,0,0,0,0,0,0,0,0,0,0,0,0,0,0,0,0,0,0,0,0,0,0,0,0,0,0,0,0,0,0,0,0,0,0,0,0,0,0,0,0,0,0,0,0,0,0,0,0,0,0,0,0,0,0,0,0,0,0,0
0,0,0,0,0,0,0,0,0,0,0,0,0,0,0,0,0,0,0,0,0,0,0,0,0,0,0,0,0,0,0,0,0,0,0,0,0,0,0,0,0,0,0,0,0,0,0,0,0,0,0,0,0,0,0,0,0,0,0,0,0,0,0,0,0,0,0,0,0,0,0,0,0,0,0,0,0,0,0,0,0
2,2,2,2,2,2,2,2,2,0,2,2,2,2,0,2,2,2,2,2,2,2,2,0,0,2,0,0,2,2,2,0,0,2,2,2,2,2,2,2,0,0,2,2,2,2,2,2,2,0,2,2,0,2,2,2,2,2,0,2,2,2,2,1,2,2,0,2,0,0,0,0,0,0,0,0,2,2,2,2,0
1,1,1,1,1,0,1,1,1,0,5,1,1,1,0,1,1,1,0,5,1,1,1,0,0,5,0,0,5,1,1,0,0,5,5,1,1,1,1,5,0,0,5,1,1,1,1,1,6,0,1,1,0,1,5,1,1,1,0,1,1,1,1,1,1,1,0,1,0,0,0,0,0,0,0,0,1,1,1,1,0
0,0,0,0,0,0,0,0,0,0,0,0,0,0,0,0,0,0,0,0,0,0,0,0,0,0,0,0,0,0,0,0,0,0,0,0,0,0,0,0,0,0,0,0,0,0,0,0,0,0,0,0,0,0,0,0,0,0,0,0,0,0,0,0,0,0,0,0,0,0,0,0,0,0,0,0,0,0,0,0,0
0,0,0,0,0,0,0,0,0,0,0,0,0,0,0,0,0,0,0,0,0,0,0,0,0,0,0,0,0,0,0,0,0,0,0,0,0,0,0,0,0,0,0,0,0,0,0,0,0,0,0,0,0,0,0,0,0,0,0,0,0,0,0,0,0,0,0,0,0,0,0,0,0,0,0,0,0,0,0,0,0
